Type,Product,Started Date,Completed Date,Description,Amount,Fee,Currency,State,Balance
TRANSFER,Current,2021-09-05 11:32:41,2021-09-05 11:32:41,transfer,-250,0,EUR,COMPLETED,165.52
CARD_PAYMENT,Current,2021-09-03 18:13:48,2021-09-05 18:22:20,company äöå,-9.5,0,EUR,COMPLETED,156.02
CARD_PAYMENT,Current,2021-09-04 17:43:49,2021-09-06 6:11:59,food,-4.85,0,EUR,COMPLETED,151.17
TOPUP,Current,2021-09-06 14:17:31,2021-09-06 14:17:33,Auto Top-Up,500,0,EUR,COMPLETED,651.17
CARD_PAYMENT,Current,2021-09-05 13:57:46,2021-09-06 21:16:43,shop a,-51.13,0,EUR,COMPLETED,600.04
CARD_PAYMENT,Current,2021-09-06 14:17:31,2021-09-07 12:59:00,shop b,-5.07,0,EUR,COMPLETED,594.97
CARD_PAYMENT,Current,2021-09-07 16:53:28,2021-09-08 7:17:49,food,-14.14,0,EUR,COMPLETED,580.83
